            ###################
            #   #   #        F####################################
            #   #  E#                                            #
            #   #####         ################################## #
            #                 #                                # #
############################  #################                # #
#                                             #                # #
#       ##################                    #                # #
#                        #####                #                # #
#      ###############       #                #                # #
#      #                     #                #                # #
###################  ##########################                # #
                #L                      #                      # #
                #             #     #   ######################## #
                #             #     #                            #
                ############  #     #   ##########################
                #             #     #   #
                #             #######   #
                #             #     #   #
                #             #     #   #
                #             #     #  S#
                #########################

